https://github.com/OCNYang/PageTransformerHelp

Banner Style
AccordionTransformer	AccordionTransformer
BackgroundToForegroundTransformer	BackgroundToForegroundTransformer
CubeInTransformer	CubeInTransformer
CubeOutTransformer	CubeOutTransformer
DepthPageTransformer	DepthPageTransformer
FlipHorizontalTransformer	FlipHorizontalTransformer
FlipVerticalTransformer	FlipVerticalTransformer
ForegroundToBackgroundTransformer	ForegroundToBackgroundTransformer
ParallaxTransformer	ParallaxTransformer
RotateDownTransformer	RotateDownTransformer
RotateUpTransformer	RotateUpTransformer
ScaleInOutTransformer	ScaleInOutTransformer
StackTransformer	StackTransformer
TabletTransformer	TabletTransformer
ZoomInTransformer	ZoomInTransformer
ZoomOutSlideTransformer	ZoomOutSlideTransformer
ZoomOutTranformer

Card Style
Style Name	Demo Pic
AlphaAndScalePageTransformer	AlphaAndScalePageTransformer
AlphaPageTransformer	AlphaPageTransformer
CascadingPageTransformer	CascadingPageTransformer
RotateDownPageTransformer
